op.j.......df
as.k.......gh
..#########..
..#########..
..#########..
..#########..
..#########..
..#########l;
..#########..
..#########..
..#########..
ty...j...z.qw
ui...k...x.er